f	f	f	f	f	f	f	r	f	f	f	f	f	f	f	f	f	f	f
f	f	f	f	f	f	f	r	f	f	f	f	f	f	f	f	f	f	f
r	r	r	r	r	r	r	r	f	f	f	f	f	f	f	f	f	f	f
f	f	f	f	r	w	w	r	f	f	f	f	f	f	f	f	f	f	f
f	f	f	f	r	w	w	r	f	f	f	f	f	f	f	f	f	f	f
f	f	f	f	r	w	w	r	f	f	f	f	f	f	f	f	f	f	f
f	f	f	f	r	w	w	r	r	r	r	r	r	r	r	r	r	r	r
f	f	f	f	r	w	w	w	w	r	w	w	w	w	w	w	w	w	w
f	f	f	f	r	w	w	w	w	r	w	w	w	w	w	w	w	w	w
f	f	f	f	r	r	r	r	r	r	w	w	w	w	w	w	w	w	w
f	f	f	f	r	w	w	w	r	r	w	w	f	f	f	f	f	f	f
f	f	f	f	r	w	w	w	r	r	w	w	f	f	f	f	f	f	f
f	f	f	f	r	w	w	w	r	r	w	w	f	f	f	f	f	f	f
f	f	f	f	r	w	w	w	w	w	w	w	f	f	f	f	f	f	f
f	f	f	f	r	w	w	w	w	w	w	w	f	f	f	f	f	f	f
f	f	f	f	r	w	w	w	w	w	w	w	f	f	f	f	f	f	f
f	f	f	f	r	w	w	w	w	w	w	w	f	f	f	f	f	f	f
f	f	f	f	r	w	w	w	w	w	w	w	f	f	f	f	f	f	f
f	f	f	f	r	r	r	r	r	r	r	r	r	r	r	r	r	r	r